##################
#SD DDDD DDDDDDDD#
# D D  D D      D#
#DD D DD DDD   DD#
#D  D D    D TDD #
#DDDD DDDDDD DD  #
#TTT         D  T#
#DDDDDDDDDDDDD T #
#D               #
#DDDDDDDDDDDDDDDC#
##################
